******##############################
******#...#...#...#...........#.....
******###.###.#.###.#.#######.#.###.
*******.#.....#...#.#...#...#...#...
******#.#####.#.#.#.###.#.#.#####.##
******#.....#.#.#.#.#.#.#.#.......#.
###########.#.#.###.#.#.#.###.#####.
#...#.......#.#.....#...#.#...#.#...
#.###.#######.#.###.#####.#.###.#.##
#...#...#...#...#.#...#...#.#...#...
#.#.#.###.#.#####.#.###.#####.#.###.
#.#.#.....#.......#.#...#.....#.#...
#.###.###########.#.#.###.###.#.#.#.
#...#...#.........#.#.....#...#...#.
###.###.#.#######.#################.
#...#...#...#...#.......#.#...#.....
#.#.#######.#.#.#######.#.#.#.#.####
#.#.#.......#.#...#...#.#.#.#.#.#...
#.###.#######.###.#.#.#.#.#.#.#.###.
#.#.........#.#.#.#.#.#.#...#.....#.
#.#.#########.#.#.#.#.#.#########.#.
#.#.........#...#.#.#...........#.#.
#.#########.#####.#############.#.#.
#...........#...#.....#.........#...
#############.#######.###.###.#####.
#...#.......#.....#...#...#...#...#.
#.###.#####.#####.#.#.#.#####.#.#.#.
#.#...#...#.....#...#.#.#...#...#...
#.#.###.#.#.#####.###.#.###.########
#.#.#.#.#.#.......#...#.....#*******
#.#.#.#.#.#########.###.#####*******
#.#...#.#...#.....#.#.#.#...#*******
#.#.###.###.#.###.#.#.#.#.###*******
#.#.....#...#.#...#.....#...#*******
#.###.###.#.#.#.###########.#*******
#.....#...#...#.............********
####################################
