......+++++++++++++++++++++++++++++++
......+...+...+...+...........+.....+
......+++.+++.+.+++.+.+++++++.+.+++.+
........+.....+...+.+...+...+...+...+
......+.+++++.+.+.+.+++.+.+.+++++.+++
......+.....+.+.+.+.+.+.+.+.......+.+
+++++++++++.+.+.+++.+.+.+.+++.+++++.+
+...+.......+.+.....+...+.+...+.+...+
+.+++.+++++++.+.+++.+++++.+.+++.+.+++
+...+...+...+...+.+...+...+.+...+...+
+.+.+.+++.+.+++++.+.+++.+++++.+.+++.+
+.+.+.....+.......+.+...+.....+.+...+
+.+++.+++++++++++.+.+.+++.+++.+.+.+.+
+...+...+.........+.+.....+...+...+.+
+++.+++.+.+++++++.+++++++++++++++++.+
+...+...+...+...+.......+.+...+.....+
+.+.+++++++.+.+.+++++++.+.+.+.+.+++++
+.+.+.......+.+...+...+.+.+.+.+.+...+
+.+++.+++++++.+++.+.+.+.+.+.+.+.+++.+
+.+.........+.+.+.+.+.+.+...+.....+.+
+.+.+++++++++.+.+.+.+.+.+++++++++.+.+
+.+.........+...+.+.+...........+.+.+
+.+++++++++.+++++.+++++++++++++.+.+.+
+...........+...+.....+.........+...+
+++++++++++++.+++++++.+++.+++.+++++.+
+
+
+
+
+
+
+
+
+
+
+