############
#..+.......#
##..####+..#
#..+##.....#
#..#.......#
#..#.......#
#.###.+.#..x
#...#...+..#
############
